1,1,1,1,2,1,1,1,1,1,1,1,1,1,2,1,1,1,1,1
1,0,0,0,0,0,0,0,0,0,0,1,0,0,0,0,0,0,0,1
1,0,0,0,0,0,0,8,0,0,0,1,28,0,0,0,0,8,0,1
1,1,1,1,1,1,0,0,0,1,29,1,1,1,1,1,0,0,0,1
1,0,0,0,0,0,0,0,0,0,0,0,0,0,0,0,0,0,0,1
1,4,0,0,0,0,0,0,10,0,0,0,0,0,0,0,0,0,0,1
1,1,1,1,1,1,1,0,0,0,1,1,1,1,3,1,1,0,0,1
1,0,0,0,0,0,0,0,0,0,0,0,0,0,0,0,0,0,0,1
1,0,0,0,0,0,0,0,0,0,0,0,0,0,0,0,0,0,0,1
1,0,9,0,0,0,0,0,0,0,0,0,0,0,0,0,0,0,0,1
1,1,1,1,3,1,1,1,1,1,1,1,1,1,1,1,1,1,1,1
