1,1,1,1,1,1,1,1,1,1,1,1,1,2,1,1,1,1,1,1,1,1,1
1,0,0,0,0,0,0,0,0,0,0,0,0,0,0,0,0,0,0,0,0,0,1
1,0,0,0,19,0,0,0,0,0,0,0,0,0,0,0,0,0,0,0,0,0,1
1,1,2,1,1,0,0,0,0,0,0,0,0,0,0,0,1,24,1,1,2,1,1
1,0,0,0,0,0,0,0,0,0,0,19,0,0,0,0,0,0,0,0,0,0,1
1,0,0,0,0,0,0,0,0,0,1,1,1,1,0,0,0,0,0,0,0,0,1
1,0,0,0,0,0,0,0,0,0,0,0,0,0,0,0,0,1,1,1,1,0,1
1,0,0,0,1,1,24,2,0,0,0,0,0,0,0,0,0,0,0,0,0,0,1
1,0,0,0,0,0,0,0,0,1,1,1,1,0,0,0,0,0,0,0,0,0,1
1,0,0,0,0,0,0,0,0,0,0,0,0,0,0,0,0,0,0,0,0,0,1
1,0,0,0,0,0,0,0,0,0,0,0,0,0,0,0,0,0,0,0,0,0,1
1,0,0,0,0,0,0,19,0,0,0,0,0,0,1,0,0,0,0,0,0,0,1
1,0,0,0,0,2,1,1,0,0,0,0,0,0,1,1,24,1,1,1,1,0,1
1,0,0,0,0,1,0,0,0,0,0,0,0,0,0,0,0,0,0,0,0,0,1
1,0,9,0,0,1,28,0,0,0,0,0,0,0,19,0,0,0,0,0,0,4,1
1,1,1,3,1,1,1,21,1,1,1,1,1,1,1,1,1,2,1,1,1,1,1
