1,1,1,1,1,1,11,1,1,2,1,1,1,1,1,1,1
1,4,1,0,0,0,0,0,0,0,0,0,0,0,0,0,1
1,0,0,0,0,0,0,0,0,0,0,0,0,0,0,0,1
1,0,0,0,0,0,0,1,1,1,1,1,24,1,1,1,1
1,0,0,0,0,0,0,0,0,0,0,0,0,0,0,1,1
1,0,0,0,0,0,0,0,0,0,0,0,0,0,28,1,1
1,3,1,1,1,1,1,1,0,17,0,1,1,1,1,1,1
1,0,0,0,0,0,0,0,0,0,0,0,0,0,0,0,1
1,9,0,0,0,0,0,0,0,0,0,0,0,0,0,0,1
1,1,1,1,1,3,1,1,1,1,1,1,1,3,1,1,1
