1,1,1,1,1,1,1,1,1,1,29,1,1,32,1,1,1,1,1,1,1,1,1
1,0,0,0,0,0,0,0,0,0,0,0,0,0,0,0,0,0,0,0,0,0,1
1,0,0,0,0,0,0,0,0,0,0,0,0,0,0,0,0,0,0,0,0,0,1
1,0,0,0,0,0,0,0,0,0,0,0,0,0,0,0,0,0,0,0,0,0,1
1,0,0,0,0,0,0,0,0,0,0,0,0,0,28,0,0,0,0,0,0,0,1
1,0,9,0,0,0,0,0,0,0,0,0,1,1,1,1,0,0,0,0,0,4,1
1,1,1,1,30,1,1,33,1,1,1,1,1,1,1,1,1,1,1,1,1,1,1
