1,1,1,1,1,29,1,1,1,1,1,1,1,1,1,1,1,1,1,1,
1,0,0,0,0,0,0,0,0,0,0,0,0,0,0,0,0,0,0,1,
1,0,10,0,0,0,0,0,0,9,0,0,0,0,0,0,0,8,0,1,
1,0,0,0,1,1,3,0,1,1,1,29,1,1,1,1,0,0,0,1,
1,0,0,0,0,0,0,16,0,0,1,0,0,0,0,0,0,0,0,1,
1,0,0,0,0,0,0,0,0,0,1,28,0,0,0,0,0,0,0,1,
1,0,0,0,0,0,0,0,0,4,1,1,1,0,0,0,1,1,1,1,
1,0,0,0,1,1,1,1,1,1,1,0,0,0,0,0,0,0,0,1,
1,0,0,0,0,0,0,0,0,17,0,0,0,0,0,0,0,0,0,1,
1,0,0,0,0,0,0,0,0,0,0,0,0,0,15,0,0,0,0,1,
1,0,0,0,0,0,0,0,0,0,0,0,0,0,0,0,0,0,0,1,
1,1,1,1,1,3,1,1,1,1,1,1,1,1,1,1,1,3,1,1,
