1,1,1,1,1,1,1,29,1,1,1,1,1,1,1,1,1,1,1,1,1,1,1,1,1,1,2,1,1,1,
1,0,0,0,0,0,0,0,0,0,0,0,1,0,0,0,0,0,0,0,0,0,0,0,0,0,0,0,0,1,
1,0,0,0,0,0,0,0,0,0,0,0,0,0,0,0,0,0,0,0,0,0,0,0,0,0,0,0,0,1,
1,1,1,1,1,0,0,0,0,0,0,0,0,1,1,1,1,0,0,0,0,0,0,0,0,1,30,1,1,1,
1,0,0,0,0,0,0,0,0,0,0,0,0,0,0,0,0,0,26,0,0,0,0,0,0,0,0,0,0,1,
1,4,0,0,0,0,0,0,1,1,1,0,0,0,0,0,0,0,26,0,0,0,0,0,0,0,0,0,0,1,
1,1,1,1,21,1,1,1,1,1,2,1,1,1,0,0,0,0,25,0,1,1,2,1,1,1,0,0,0,1,
1,0,0,0,0,0,0,0,0,0,0,0,0,1,0,0,0,0,0,0,0,0,0,0,0,0,0,26,0,1,
1,0,0,0,19,0,0,0,0,0,0,0,0,0,0,0,0,0,0,0,0,0,0,0,0,0,0,26,0,1,
1,0,1,1,1,1,0,0,0,1,1,1,23,1,0,0,0,0,0,1,1,1,0,0,0,0,0,26,0,1,
1,0,0,0,0,0,0,26,0,0,0,0,0,0,0,0,0,0,0,0,0,0,0,0,0,0,0,26,0,1,
1,0,0,0,0,0,0,26,0,0,0,0,0,0,0,28,0,0,0,0,0,0,0,0,0,0,0,26,0,1,
1,1,1,3,1,1,0,25,0,1,1,1,0,0,0,1,2,0,0,0,0,0,0,1,1,1,0,25,0,1,
1,0,0,0,0,0,0,0,0,0,0,0,0,0,0,0,0,0,0,0,0,0,0,0,0,0,0,0,0,1,
1,0,9,0,0,0,0,0,0,0,0,0,0,0,0,0,0,0,0,0,0,0,0,0,0,0,0,0,0,1,
1,1,1,1,1,1,1,3,1,1,1,1,1,1,1,1,1,1,1,1,1,1,3,1,1,1,1,1,1,1,
